amare = amat lieben, mögen
soror = sororem f. die Schwester
respondere = respondet antworten
iterum = Adv. wieder
statim = Adv. sofort
puer = puerum m. das Kind, der Junge
puella = puellam f. das Mädchen
frater  = fratrem m. der Bruder
itaque = Adv. deshalb
sunt = sie sind
culina = culinam f. die Küche
debere = debet müssen
non debere = nicht dürfen
adhuc = Adv. bis jetzt, noch
illic = Adv. dort
liberi = liberos m. Pl. die Kinder
vir = virum m. der Mann
atrium = atrium n. das Atrium
otium = otium n. die Ruhe, die Freizeit
parentes = parentes m. Pl. die Eltern
peristylium = peristylium n. das Peristyl
officium = officium n. die Pflicht
explere = explet erfüllen
Salvete! = Seid gegrüßt!
dicere = dicit sagen
cur? = warum?
semper = Adv. immer
placere = placet gefallen, Spaß machen
labor = laborem m. die Mühe, die Arbeit
neglegere  = neglegit vernachlässigen, nicht beachten
pergere = pergit etw. weiter tun, fortsetzen