forum = forum n. das Forum, der Marktplatz
Romanus = Romanus m., Romana f., Romanum n., römisch
multi = multi m. Pl., multae f. Pl., multa m. Pl., viele
monumentum = monumentum n. das Denkmal
statua = statuam f. die Statue
parvus = -a, -um klein
magnus = -a, -um groß
pulcher = pulcher m., pulchra f., pulchrum n., schön
prope = Präp. + Akk. nahe bei
homo = -em, -es m. der Mensch, der Mann
conspicere = conspicio erblicken, sehen
accedere = accedo sich nähern, herbeikommen
iratus = -a, -um zornig, wütend
amicus = amicum m. der Freund
amica = amicam f. die Freundin
facere = facio machen, tun
cupere = cupio wollen, wünschen
praebere = praebeo bieten, gewähren
tam = Adv. so
capere = capio fangen, ergreifen
accusare = accuso beschuldigen
incipere = incipio anfangen, beginnen
fur = -em, -es m. der Dieb
malus = -a, -um schlecht, böse
fugere = fugio fliehen, entkommen
aureus = -a, -um golden
donum = donum n. das Geschenk
reddere = reddo zurückgeben
aut = Konj. oder
mors = -em, -es f. der Tod
manere = maneo bleiben, erwarten
bonus = -a, -um gut
rectus = -a, -um gerade, richtig, ehrlich
miser = -a, -um arm, unglücklich
profecto = Adv. tatsächlich
tutus = -a, -um sicher