ascendere = ascendo, ascendi besteigen, hinaufsteigen
templum = templi n. der Tempel
procul = Adv. von fern, weit, von weitem
deus = dei m. der Gott
dea = deae f. die Göttin
nuper = Adv. neulich
audire = audio, audivi hören
scribere = scribo, scripsi schreiben
fabula = fabulae f. die Sage, die Erzählung
legere = lego, legi lesen
narrare = narro, narravi erzählen
quondam = Adv. einst
oppugnare = oppugno, oppugnavi angreifen, bestürmen
femina = feminae f. die Frau
arx = arcis f. Gen. Pl. arcium die Festung, die Anhöhe
fugere = fugio, fugi + Akk. fliehen, entkommen, meiden
obsidere = obsideo, obsedi belagern
arcere = arceo, arcui abwehren, fernhalten
fames = famis f. der Hunger
urgere = urgeo, ursi drängen, bedrängen
tamen = Adv. dennoch, trotzdem
abstinere = abstineo, abstinui fernhalten
sacer = sacra, sacrum heilig, geweiht
forte = Adv. zufällig
conspicere = conspicio, conspexi erblicken, sehen
nox = noctis f. Gen. Pl. noctium die Nacht
neque ... neque = weder ... noch
custos = custodis m. der Wächter
miles = militis m. der Soldat
animadvertere = animadverto, animadverti merken, bemerken
excitare = excito, excitavi aufschrecken, aufwecken
intrare = intro, intravi betreten, eintreten
primus = -a, -um der erste
iactare = iacto, iactavi werfen, schleudern
venire = venio, veni kommen
adiuvare = adiuvo, adiuvi unterstützen
servare = servo, servavi retten
ad = Präp. + Akk. zu, bei
sacrum = sacri n. das Opfer
facere = facio, feci machen, tun
debere = debeo, debui müssen
defendere = defendo, defendi verteidigen
pugnare = pugno, pugnavi kämpfen
dicere = dico, dixi sagen
videre = video, vidi sehen
deponere = depono, deposui ablegen