cum = Präp. + Abl. mit, zusammen mit
thermae = thermarum f. Pl. die Thermen
primum = Adv. zunächst, zuerst
in = Präp. +  Abl. in, an, auf, bei
toga = togae f. die Toga
deponere = depono ablegen
vestis = vestis f. die Kleidung
saepe = Adv. oft
septimus = -a, -um der siebte
hora = horae f. die Stunde
e, ex = Präp. + Abl. aus, von
silentium = silentii n. die Stille, das Schweigen
iucundus = -a, -um erfreulich, angenehm
pauci = -ae, -a Pl. wenige, nur wenige
aqua = aquae f. das Wasser
nihil = nichts
cogitare = cogito denken
at = Konj. aber
vox = vocis f. die Stimme
excitare = excito aufschrecken, aufwecken
patronus = patroni m. der Schutzherr, der Patron
sermo = sermonis m. das Gespräch
consilium = consilii n. der Rat, die Beratung
egregius = -a, -um hervorragend, herausragend, ausgezeichnet
occupatus = -a, -um beschäftigt
ire = eo, is, it, imus, itis, eunt gehen
molestus = -a, -um lästig, unangenehm
secum = bei sich
aestas = aestatis f. der Sommer
errare = erro irren, sich irren
quo? = Adv. wohin?
a, ab = Präp. + Abl. von
accipere, accipo annehmen, aufnehmen, empfangen