equus = equum m. das Pferd
ego/me = Pers.-Pron. ich/mich
tu/te = Pers.-Pron. du/dich
nos/nos = Pers.-Pron. wir/uns
vos/vos = Pers.-Pron. ihr/euch
canis = canem m. der Hund
delectare = delecto erfreuen
bos = bovem m. das Rind, der Ochse
alere = alo nähren, ernähren
paulo post = ein wenig später
villa = villam f. das Landhaus, das Landgut
salutare = saluto grüßen
iam = Adv. schon, gleich, jetzt
uxor = uxorem f. die Ehefrau
cena = cenam f. die Mahlzeit, das Essen
parare = paro vorbereiten, zubereiten
adiuvare = adiuvo unterstützen
in = Präp. + Akk. in
properare = propero eilen, sich beeilen
instruere = instruo anweisen, unterrichten
ante = Präp. + Akk. vor
agere = ago tun, handeln
ad = Präp. + Akk. zu
bene = Adv. gut
caedere = caedo töten, schlachten
servare = servo retten
certe = Adv. sicher, gewiss
hortus = hortum m. der Garten
esse = sum, es, est, sumus, estis, sunt sein
per = Präp. + Akk. über, durch
autem = Konj. aber
obsecrare = obsecro anflehen
igitur = Adv. also