schola = scholam f. die Schule
ducere = duco führen
vocare = voco rufen
magister = magistrum m. der Lehrer
sedere = sedeo sitzen
considere = consido sich hinsetzen
-que = Konj. und
habere = habeo haben, halten
-ne? = zeigt an, dass es sich um eine Frage handelt
tabula = tabulam f. das Wachstäfelchen
discipulus = discipulum m. der Schüler
discipula = discipulam f. die Schülerin
nonne? = etwa nicht?, doch wohl?
posse = possum, potes, potest, possumus, potestis, possunt können
discere = disco lernen
num? = denn?, etwa?
scribere = scribo schreiben
atque = Konj. und
legere = lego lesen
tacere = taceo schweigen
monere = moneo ermahnen, mahnen
noli, nolite = + Inf. zeigt an, dass es sich um ein Verbot handelt
ita = Adv. so
postea = Adv. danach, später
quis? = wer?
monstrare = monstro zeigen
ridere = rideo lachen, jemanden auslachen
domum = nach Hause
punire = punio bestrafen
portare = porto tragen
docere = doceo unterrichten, lehren
ergo = Adv. deshalb, also