Circus Maximus = Circi Maximi m. der Circus Maximus
spectator = spectatoris m. der  Zuschauer
gaudium = gaudii n. die Freude
agitator = agitatoris m. der Wagenlenker
praeclarus = -a, -um berühmt, ausgezeichnet
tandem = Adv. schließlich, endlich
tunica = tunicae f. die Tunika
meus = -a, -um Possesivpronomen mein
tuus = -a, -um dein
noster  = -tra, -trum unser
vester = tra, -trum euer, eure
suus = -a, -um reflexives Possesivpronomen sein, ihr
eius = nicht-reflexives Possesivpronomen sein, ihr, dessen, deren
eorum = earum, eorum nicht-reflexives Possesivpronomen Pl. deren
vincere = vinco siegen, besiegen
verbum = verbi n. das Wort
iam = Adv. schon, gleich, jetzt
non iam = Adv. nicht mehr
signum = signi n. das Zeichen
imperator = imperatoris m. der Kaiser
tuba = tubae f. die Trompete
canere = cano ertönen
dare = do geben
cuncti = -ae, -a Pl. alle
incitare = incito antreiben, anfeuern
ceteri = -ae, -a Pl. die übrigen
arcere = arceo abwehren, fernhalten
surgere = surgo aufstehen, sich erheben
inter = Präp. + Akk. zwischen, unter
spina = spinae f. die Trennmauer
meta = metae f. die Wendemarke
quadrigae = quadrigarum f. Pl. das Viergespann
praestare = praesto sich hervortun, sich auszeichnen, besser sein
crescere = cresco wachsen
simul = Adv. gleichzeitig, zugleich
fere = Adv. fast, etwa
tangere = tango berühren
mortuus = -a, -um tot
se = Akk. sich
pecunia = pecuniae f. das Geld
spectare = specto anschauen, betrachten, sehen
auditor = auditoris m. der Zuhörer
victor = victoris m. der Sieger